11111111111111111111111111111111111111
1P00C1000011111111111111000000000000E1
1000011000C0100000111111C0001000000001
11C00010000001000C111111000110C0000001
10000C111111001C0000000100000000000001
110001111111101000000C01C0010000000001
1000000011111C1000001111000C0000001111
10000100010000010000000100000001111111
1C00010001C00001000000C100000000111111
10000100001000010000111111101111111111
100C00010010000100011111C00000C0001111
100000010000000100C000C100010000011111
1000001110000C0100C0011100000001111111
11110001100001110000001101111111111111
10000001100000110C00000100000000111111
1C000001000000010000011100000000011111
10000000000000000000000000000000000011
1C000000000C000000000000C0000000000001
10000000000000000000000000000000000001
11111111111111111111111111111111111111