1111111111111111111111111111111111
1E000C00011111111111111000000000P1
10001100001111111111110000C0001111
100000000000CCCCCCCC00000000000001
1111111111111111111111111111111111