1111111111111111111111111111111
1000000000000000000000000000001
1000000000000000000000111111101
1000000000110000000000000000101
1P000000001100000000000000001C1
1000000000110000000000000000111
10000000001100000000000000000E1
1111111111111111111111111111111