11111111111111111111111
1E0001000C0100010010001
10C0010C0001C011001C001
1000C1000001000C00001C1
10000000000P00000000001
11111111111111111111111
11111111101110000011111
11111111011111111011111
11111110111111111011111
11111100001110000011111
11111111101110111111111
11111111101110111111111
11111111101110000011111
11111111111111111111111