111111111111111111
111C000010000000C1
1E10000010C1111101
101001001001111101
101001001C00000111
101001C000011000C1
100000111111100001
1000000C11111C0101
1C0000001111100101
1111110C1111100101
111111111111100101
1C00000C1111100101
1000000000C11C0001
1111000000011000C1
111101110001100111
11110111C001100111
100000000100000001
1000000000000000C1
111111111P11111111
111111111111111111