11111111
10000001
1C000001
100000E1
10000001
100P0001
11111111