11111111
1P000001
1C000001
100000E1
11111111