111111111111111111111111
1P000000000C0C0C00000001
1E1000C000000C0000000001
10010000C0000C0000C00001
1000000000000000000000P1
111111111111111111111111