1111111111111111111111111111111
10000000000000000E0000000000001
1111000000000000000001111111111
1100000000000000000011111111111
10000000000000000000011111100P1
1000000000000000000000011100001
1000000000000000000000000000001
1111111111111111111111111111111