111111111111111111111111111111111111111
1000000000000000P0000000000000000011111
111100000000000000000001111100000000111
11100C000000000000000011111110000000011
110000000000C000000000011111000C0000001
100000000000000000000000111000000000001
1000000000C0000000000000010000000000001
100000C0000001111000000C000000000C00001
111111111111111111111111111111111111111