11111111111111111111111111111
1P00000C0000000000C00000C00001
100000000000E0000000000000001
10001110000000001111011100001
11111111111111111111111111111