1111111111111111111111111111111
1E000000000010000C00000C0000001
100000000000100000000C000000C01
100000000000100000C00000C000001
1111111111111C0000000C00000C001
10000000000000000C0000000000001
10000000000000000000000000000P1
1111111111111111111111111111111