111111111111111111111111111111
10000000000P000000000000000001
1EC000000000111200000000000001
111111111111111111111111111111