111111111111111111111111111
1P000000000000000001CCCCCC1
10000000000000000001CCCCCC1
10000000000000000001CCCCCC1
10000000000000000001CCCCCC1
100000000000000000011111111
1000000000000000000000000E1
111111111111111111111111111