111111111111011111111111111111111
1000000000000000000000000000000P1
1E00000000000C000000000CC00000001
111111111111111111111111111111111